111111111111101111111
100X00000000001000001
101111111011111011101
100000001000001010101
111110111110101010101
100002100010120000101
101111101010111110101
101000001010000X10001
101011111011111110101
101010001002100010101
10101011111010101X101
101010000010001010101
1X1011111011111010101
101000001000000000101
111111101111111111111
