111111111111111111111
100000001011100011100
101110011000000001001
101010001001100101001
100000111111001100001
100110000000011001101
100010001110000011001
101110100011110110011
101000101010100011001
101010101110001001101
101010101010011100001
001010100000101000101
101110001111100011101
100000000000100000001
111111111111111111111