111111111111111111111
100010001000100000100
111011101010111010101
100010001010100010001
101010111010101111101
101010000010100000101
101111111110111010111
100000000000001010001
101110101111101111101
101000101000101000001
101011101010101011101
101000101010100010001
101110111010111110111
000010000010000000001
111111111111111111111