111111111111111111111
000010000000001000001
101010111111111011101
101000100000000000101
101111111110111110101
101000000010001010101
101011111011101010111
101000101000000010001
101110101110111111101
100010100010100000101
111010111010101110101
101000100010101010101
101111101110101010101
100000000000001000000
111111111111111111111