111111011111111111111
100000000200000000001
101111111111111011101
100000000000001000101
1111111111111X1110111
120000001000100010001
101111101011111011111
101000100010001002001
101010111010101111101
10101000001X100000101
101011111010101110101
101210001010101000101
1011101011101X1111101
100000100000100000001
111111111111101111111