111111111111111111111
100000001000001000000
101110101011101011101
101000101000101000101
101011101110101110101
101010000000100010101
101010111111111110101
101010101000000010101
101010101011111010101
101010001010001010101
101011111010111010101
101000100010101000101
101110101110101111101
100010000000100000001
111011111111111111111