111111111111111111111
101000000000000000001
101011111110111111101
100000100010001000101
111111101010101110101
100000001010100010001
101011111011111010111
101010001010001010101
101011101010101010101
101010001000101010001
101110111111101011101
000010001010001000101
101011101010111110101
101000001000000000100
111111111111111111111