111111111111111111111
000000000010000X00001
111111101010111111101
100000001000100012001
101111111111101011111
101000100000001000001
101010101111111111101
100010000210000000001
101111111110111111101
100000101000120000001
11111X101011111111101
10021010100000X000101
101110101111111110101
100000001000000000100
111111111111111111111