111111111111111111111
100000000010000000101
111011111011101110101
100010000000001000001
101111111111101111111
101000100000101000001
101010101110111011101
000010101010001000101
101110101011101011101
101010101000101010000
101010101010101011111
100010100010100010001
111010111110111110101
100010000000000000101
111111111111111111111