111111111111111111111
100000001000000000001
101011111010111111101
101000000010100000101
101111111110101111101
000010001000101010001
111010101010101010111
101010100010101000000
101010111111101111111
100010000000101000001
101111111110101011101
101000000010100010001
101111111010111110111
100000000010000000001
111111111111111111111