111111111111111111111
0010000000000000000X1
101011111110111111111
101012000010001000001
1010111110111X1011101
101000000010001012101
101110111110101010101
100000000000101X10001
101111101111111110111
100012100010000010001
111010111010101111101
100010001000100002101
101111101111111011101
100000000000001000000
111111111111111111111