111111111111111111111
00001000000X000010001
111010111110111110101
100010000010000000101
101111101011111111101
1000100012000010000X1
1X1010111011101011101
101010001000100010001
101010111110101111111
101000100000101X10000
101111101111101010101
1000001010000X1000101
111110101111111111101
100002100000000000001
111111111111111111111