111111111111111111111
000010000000001000001
101010111111111011101
1010X0100000000020101
101111111110111110101
101000000010001010101
101011111011101010111
10100010100000X010001
121110101110111111101
100010100010100000101
111010111X10101110101
101000100010101010101
101111101110101010101
10000000000000100X000
111111111111111111111