111111111011111111111
100000000010000000001
101011111010111111101
101010000010000010101
101011101111111010101
101000101000000010001
101110101011111111111
100010101010000010001
111110101011101010111
100000101000001010001
101111111111111011101
100010000000100010001
101010111110101110101
101000000010000000101
111111111111111111101