111111111111111111111
10001000100010X000120
111011101010111010121
100X100X1010100010221
10101011101X101111101
1010100000101X0000101
101111111110111010111
100000000000001010001
1011101011111011111X1
101000101000101000001
101011101010101011101
10100010101010X010001
101110111010111110111
000010X00010000000001
111111111111111111111