111111111111111111111
10X000000010000000101
111011111011121110101
100010000000001000X01
101111111111101111111
10100010X000101000001
101010101110111011101
000010101010001002101
101110101011101011101
101010101000101010000
101010101010101011111
100010100010100010001
11121011111X111110101
100010000000000000101
111111111111111111111