111111111111111111111
001000000000000000001
101011111110111111111
101010000010001000001
101011111011101011101
101000000010001010101
101110111110101010101
100000000000101010001
101111101111111110111
100010100010000010001
111010111010101111101
100010001000100000101
101111101111111011101
100000000000001000000
111111111111111111111