111111111111111111111
000010000000000010001
111010111110111110101
100010000010000000101
101111101011111111101
100010001000001000001
101010111011101011101
101010001000100010001
101010111110101111111
101000100000101010000
101111101111101010101
100000101000001000101
111110101111111111101
100000100000000000001
111111111111111111111