111111011111111111111
100000000000000000001
101111111111111011101
100000000000001000101
111111111111101110111
100000001000100010001
101111101011111011111
101000100010001000001
101010111010101111101
101010000010100000101
101011111010101110101
101010001010101000101
101110101110101111101
100000100000100000001
111111111111101111111