111111111111111111111
100010001000000000001
111010101110111111101
101X00100000100000101
101111111111121010101
101020000000101010101
1X1011101111101X11101
100010100010001010000
101110111010111010111
101000001000101010101
101110111111101010101
100010000X10001000101
111011101010101111101
000000001000100200001
111111111111111111111