111111111111111111111
121000000000000000001
101011111110111111101
100002100010001200101
111111101010101110101
10000000101X100010001
101011111011111010111
101010001010001010101
1010111010101010101X1
101010001002101010001
101110111111101011101
000X10001010001000101
101011101010111110101
101000001000000000100
111111111111111111111