111111111110111111111
100010000010000000001
101010111011101011101
101000101000101000101
101111101110111110101
100010000010100000101
111010101110101111101
100010100010001000001
101110111011111011111
100010001000001000001
101011111011101111101
101000101000100000101
101110101010111111101
100010001010000000001
111111111011111111111