111111111111111111111
10000000100000000X001
101X11111010111111101
101000000010100000101
101111111110101111101
000010001000101010001
111010101010101010111
101010102010101000000
101010111111101111111
1X0010000000101000001
101111111110101011101
101000X00010102010001
101111111010111110111
100000000210000000001
111111111111111111111