111111111111111111111
120000001000001000000
101110101011101011101
101X0010100X101000101
101011101110101110101
101010000000100210121
101010111111111110101
101010101000000010101
101010101011111010101
101010001010001010101
101011111010111X10101
101020100010101000101
101110101110101111101
100010000000100000001
111011111111111111111