111011111111111111111
100010000010000000001
101110101110111111101
101000100010100000001
101011111010101111101
10101000102010X000101
101010101110111110111
1X10101X0010000010001
101010111011111111101
100010001010000000001
101111101010111111101
10100210101X1000X0101
101011101010101011101
100010001000101000001
111111111111101111111