111111111111111111111
100010001000000000001
111010101110111111101
101000100000100000101
101111111111101010101
101000000000101010101
101011101111101011101
100010100010001010000
101110111010111010111
101000001000101010101
101110111111101010101
100010000010001000101
111011101010101111101
000000001000100000001
111111111111111111111