111111111111101111111
100000000000001000001
101111111011111011101
100000001000001010101
111110111110101010101
100000100010100000101
101111101010111110101
101000001010000010001
101011111011111110101
101010001000100010101
101010111110101010101
101010000010001010101
101011111011111010101
101000001000000000101
111111101111111111111
